10 10
P=1,1
GAMEOVER=false
GAMEWON=false
##########
#P.....#E#
#..#.....#
#..#..#..#
#..#..#..#
#....T...#
#..####..#
#........#
#.#......#
##########
