10 10
P=5,2
GAMEOVER=false
GAMEWON=false
##########
#......#E#
#..#.....#
#..#..#..#
#..#..#..#
#.P..T...#
#..####..#
#........#
#.#......#
##########
