10 10
P=4,1
GAMEOVER=false
GAMEWON=false
##########
#......#E#
#..#.....#
#..#..#..#
#P.#..#..#
#....T...#
#..####..#
#........#
#.#......#
##########
