5 5
#####
#P#.#
##E.#
#####
#####